{
  "levels": [
    {
      "grid": [
        [1, 1, 1, 1, 1, 1, 1, 1, 1, 1],
        [1, 2, 0, 0, 0, 1, 0, 0, 0, 1],
        [1, 0, 1, 1, 0, 1, 0, 1, 0, 1],
        [1, 0, 1, 0, 0, 0, 0, 1, 0, 1],
        [1, 0, 1, 0, 1, 1, 0, 1, 0, 1],
        [1, 0, 0, 0, 0, 0, 0, 0, 3, 1],
        [1, 1, 1, 1, 1, 1, 1, 1, 1, 1]
      ]
    },
    {
      "grid": [
        [1, 1, 1, 1, 1, 1, 1, 1, 1, 1],
        [1, 2, 0, 0, 1, 0, 0, 0, 3, 1],
        [1, 0, 1, 0, 1, 0, 1, 0, 1, 1],
        [1, 0, 1, 0, 0, 0, 1, 0, 0, 1],
        [1, 0, 0, 0, 1, 0, 0, 1, 0, 1],
        [1, 1, 1, 0, 1, 0, 0, 1, 0, 1],
        [1, 1, 1, 1, 1, 1, 1, 1, 1, 1]
      ]
    },
    {
      "description": "Level with moving obstacles (symbol 'M')",
      "grid": [
        [1, 1, 1, 1, 1, 1, 1, 1, 1, 1, 1, 1],
        [1, 2, 0, 0, 0, 0, 0, 0, 0, 0, 0, 1],
        [1, 0, 1, 0, "M", 0, 1, 0, 1, 0, 1, 1],
        [1, 0, 1, 0, 1, 0, 1, 0, 1, 0, 0, 1],
        [1, 0, 0, 0, 0, 0, 0, 0, 0, 0, 0, 1],
        [1, 0, 1, 0, 1, 0, 1, 0, "M", 0, 1, 1],
        [1, 0, 1, 0, 1, 0, 1, 0, 0, 0, 0, 1],
        [1, 0, 0, 0, 0, 0, 0, 0, 0, 0, 3, 1],
        [1, 1, 1, 1, 1, 1, 1, 1, 1, 1, 1, 1]
      ]
    }
  ]
}
